||||||||||||||||||||||||||||
|......||..........||......|
|.||||.||.||||||||.||.||||.|
|.||||.||.|......|.||.||||.|
|...||.||.||||||||.||.||...|
|||.||................||.|||
  |.||.|||||.||.|||||.||.|  
|||.||.|||||.||.|||||.||.|||
   ....||....||....||....   
|||.||.|| |||||||| ||.||.|||
|||.||.|| |||||||| ||.||.|||
|...||.           o   .||..|
|.||||.|| |||||||| ||.||||.|
|.||||.|| |......| ||.||||.|
|......|| |......| ||......|
|||.||||| |......| |||||.|||
..|.||||| |||||||| |||||.|..
.||....  o           ....|..
|||.||.|| |||||||| ||.||.|  
|||.||.|| |||||||| ||.||.|||
|...||.||....||....||.||...|
|.||||.|||||.||.|||||.||||.|
|.||||.|||||.||.|||||.||||.|
|...||....... o.......||...|
|||.||.||.||||||||.||.||.|||
|||.||.||.||||||||.||.||.|||
|......||....||....||......|
|.||||||||||.||.|||||||||| |
|.	...	..	   |
||||||||||||||||||||||||||||
