||||||||||||||||||||||||||||
|............||............|
|.||||.|||||.||.|||||.||||.|
|.||||.|||||.||.|||||.||||o|
|.||......||.||.||......||o|
|p||.||||.||....||.||||.||o|
|.||.||||.||.||.||.||||.||o|
|......||.||.||.||.||......|
||||||.||....||....||.||||||
||||||.|| |||||||| ||.||||||
    ||.|| |||||||| ||.||    
||| ||.              .|| |||
  | ||.|| |||--||| ||.|| |  
||| ||.|| |      | ||.|| |||
|......|| |      | ||......|
|.||||.|| |      | ||.||||.|
|.||||.|| |||||||| ||.||||.|
|...||.||          ||.||...|
|||.||.||||| || |||||.||.|||
|||.||.||||| || |||||.||.|||
|......||....||....||......|
|.||||.||.||||||||.||.||||.|
|.||||.||.||||||||.||.||||.|
|.||.........  .......g.||.|
|.||.|||||||.||.|||||||.||.|
|.||.|||||||.||.|||||||.||.|
|......||....||....||......|
|.||||.||.||.||.||.||.||||.|
