||||||||||||||||||||||||||||
|..........................|
|.||||.||.||||||||.||.||||.|
| ||||.||.||||||||.||.||||.|
|.||...||....||....||...||.|
|.||.||||.||.||.||.||||.||.|
|.||.||||.||.||.||.||||.||.|
  ........||.||.||........o 
||||.|||| ||....|| ||||.||||
||||.|||| |||||||| ||||.||||
|......|| |||||||| ||......|
|.||||.||          ||.||||.|
|.|  |.|| |||| ||| ||.|  |.|
|.||||.|| |  ||||| ||.||||.|
|......   |||    |   ......|
||||.|||| |      | ||||.||||
...|.|||| |||||||| ||||.|   
   |.||.            .||.|...
   |.||.|||| || ||||.||.|   
||||.||.|||| || ||||.||.||||
    .........||.........    
|||||||.||.||||||.||.|||||||
|||||||.||.||||||.||.|||||||
|....||.||...  ...||.||....|
|.||.||.||.||||||.||.||.||o|
|.||.||.||.||||||.||.||.||.|
| ||....||...||...||....||.|
|.|||||.||||.||.||||.|||||.|
|.........o................|
||||||||||||||||||||||||||||
